Pirate's Treasure
An Interactive Fiction by Fisher Bricker
Release 1 / Serial number 190215 / Inform 7 build 6M62 (I6/v6.33 lib 6/12N) SD

Captains's quarters
You have been sailing for months in search of an infamous island, your watchman has spotted a small island to the east. You have pulled into a bay to dock near the island and are prepared to explore the land in search of treasure

You can see Shovel here.

>dig saand
You can't see any such thing.

>dig sand
You can't see any such thing.

>x sand
The sand seems be a color under the tree than on the rest of the island. maybe you could dig down there.

>dig sand
You can't see any such thing.

>e
Pirate Ship
A small but heavilly equipped sailing boat

You can see Shovel here.

>get shovel
Taken.

>w
Paradise Island
The island is small but lush tropical island located off the coast of mexico. It has been said that all the worldly possesions of Captain Black Beard are buried somewhere on the island. In front of you can see a piece of paper and a large tree. To the east is your Ship.

You can see Paper here.

>dig sand
(with Shovel)
you dig away the sand revealing a wooden chest

>x chest
An unlocked chest filled with thousands of gold pieces and various jewels

>take chest
Taken.

>x tree
A giant banyan that goes almost a hundred feet into the air, it must be at least 300 years old. The sand underneath the tree seems to be a different color than everywhere else on the island.

* * *

Pirate's Treasure
An Interactive Fiction by Fisher Bricker
Release 1 / Serial number 190215 / Inform 7 build 6M62 (I6/v6.33 lib 6/12N) SD

Captains's quarters
You have been sailing for months in search of an infamous island, your watchman has spotted a small island to the east. You have pulled into a bay to dock near the island and are prepared to explore the land in search of treasure

You can see Shovel here.

>e
Paradise Island
The island is small but lush tropical island located off the coast of mexico. It has been said that all the worldly possesions of Captain Black Beard are buried somewhere on the island. In front of you can see a piece of paper and a large tree. To the east is your Ship.

You can see Paper here.

>get shovel
Taken.

>w
Paradise Island
The island is small but lush tropical island located off the coast of mexico. It has been said that all the worldly possesions of Captain Black Beard are buried somewhere on the island. In front of you can see a piece of paper and a large tree. To the east is your Ship.

>unlock sand with shovel
You unlock Sand.

>open sand
You open Sand.

>x sand
The sand seems be a color under the tree than on the rest of the island. maybe you could dig down there.

* * *

>e
Paradise Island
The island is small but lush tropical island located off the coast of mexico. It has been said that all the worldly possesions of Captain Black Beard are buried somewhere on the island. In front of you can see a piece of paper and a large tree. To the east is your Ship.

You can see Paper here.

>x shovel
A large metal shovel that looks specially made for digging away at sand.

>get shovel
Taken.

* * *

>w
Paradise Island
The island is small but lush tropical island located off the coast of mexico. It has been said that all the worldly possesions of Captain Black Beard are buried somewhere on the island. In front of you can see a piece of paper and a large tree. To the east is your Ship.

>x paper
an old piece of paper that appears to be a map of the island.

>x tree
You can't see any such thing.

>x large tree
You can't see any such thing.

>x paper
an old piece of paper that appears to be a map of the island.

>x map
You can't see any such thing.

>take paper
you take the paper to get a closer look at the map.

>x map
It says that the treasure is located underneath the biggest tree on the island

>x snad
You can't see any such thing.

>x sand
The sand seems to have a different color than the rest of the island. maybe you could dig down there.

>dig sand
(with Shovel)

>drop shovel
Dropped.

>dig sand
(with Shovel)
It's almost impossibe to dig away the sand without the proper tool

* * *

Pirate's Treasure
An Interactive Fiction by Fisher Bricker
Release 1 / Serial number 190215 / Inform 7 build 6M62 (I6/v6.33 lib 6/12N) SD

Captains's quarters
You have been sailing for months in search of an infamous island, your watchman has spotted a small island to the east. You have pulled into a bay to dock near the island and are prepared to explore the land in search of treasure

You can see Shovel here.

>get shovel
Taken.

>e
Paradise Island
The island is small but lush tropical island located off the coast of mexico. It has been said that all the worldly possesions of Captain Black Beard are buried somewhere on the island. In front of you can see a piece of paper and a large tree. To the west is your Ship.

You can see Paper here.

>dig sand
(with Shovel)
you dig away the sand revealing a wooden chest

* * *

>e
Paradise Island
The island is small but lush tropical island located off the coast of mexico. It has been said that all the worldly possesions of Captain Black Beard are buried somewhere on the island. In front of you can see a piece of paper and a large tree. To the west is your Ship.

You can see Paper here.

>get paper
you take the paper to get a closer look at the map.

>xmap
That's not a verb I recognise.

>x map
It says that the treasure is located underneath the biggest tree on the island

>x tree
A giant banyan tree that goes almost a hundred feet into the air, it must be at least 300 years old. The sand underneath the tree seems to be a different color than everywhere else on the island.

>x sand
The sand seems be a color under the tree than on the rest of the island. maybe you could dig down there.

>dig sand
(with Shovel)
you dig away the sand revealing a wooden chest

* * *

>x chest
An unlocked chest filled with thousands of gold pieces and various jewels

>take chest
Taken.

    *** You win! ***

Would you like to RESTART, RESTORE a saved game, QUIT or UNDO the last command?

* * *

Pirate's Treasure
An Interactive Fiction by Fisher Bricker
Release 1 / Serial number 190215 / Inform 7 build 6M62 (I6/v6.33 lib 6/12N) SD

Captains's quarters
You have been sailing for months in search of an infamous island, your watchman has spotted a small island to the east. You have pulled into a bay to dock near the island and are prepared to explore the land in search of treasure

You can see Shovel here.

>x map
You can't see any such thing.

>x paper
an old piece of paper that appears to be a map of the island.

>take paper
you take the paper to get a closer look at the map.

* * *

>x map
It says that the treasure is located underneath the biggest tree on the island

>x tree
You see nothing special about Tree.

>look under tree
You find nothing of interest.

* * *

Pirate's Treasure
An Interactive Fiction by Fisher Bricker
Release 1 / Serial number 190215 / Inform 7 build 6M62 (I6/v6.33 lib 6/12N) SD

Captains's quarters
You have been sailing for months in search of an infamous island, your watchman has spotted a small island to the east. You have pulled into a bay to dock near the island and are prepared to explore the land in search of treasure

You can see Shovel here.

>x paper
an old piece of paper that appears to be a map of the island.

* * *

>x map
It says that the treasure is located underneath the biggest tree on the island

>x paper
You can't see any such thing.

>i
You are carrying:
  If map

>drop map
Dropped.

* * *

Pirate's Treasure
An Interactive Fiction by Fisher Bricker
Release 1 / Serial number 190215 / Inform 7 build 6M62 (I6/v6.33 lib 6/12N) SD

Captains's quarters
You have been sailing for months in search of an infamous island, your watchman has spotted a small island to the east. You have pulled into a bay to dock near the island and are prepared to explore the land in search of treasure

You can see Shovel here.

>x shovel
A large metal shovel that looks specially made for digging away at sand.

>x ship
You can't see any such thing.

>x room
You can't see any such thing.

>e
You can't go that way.

>w
You can't go that way.

>e
You can't go that way.

* * *

Pirate's Treasure
An Interactive Fiction by Fisher Bricker
Release 1 / Serial number 190215 / Inform 7 build 6M62 (I6/v6.33 lib 6/12N) SD

Captains's quarters
You have been sailing for months in search of an infamous island, your watchman has spotted a small island to the east. You have pulled into a bay to dock near the island and are prepared to explore the land in search of treasure

You can see Shovel here.

>x tree
An extremely large monkey pod tree that must be at least 200 years old.

>look under tree
You find nothing of interest.

* * *

>x tree
An extremely large monkey pod tree that must be at least 200 years old.

>x sand
The sand seems to have a different color than the rest of the island. maybe you could dig down there.

>look under tree
You find nothing of interest.

* * *

Pirate's Treasure
An Interactive Fiction by Fisher Bricker
Release 1 / Serial number 190215 / Inform 7 build 6M62 (I6/v6.33 lib 6/12N) SD

Captains's quarters
You have been sailing for months in search of an infamous island, your watchman has spotted a small island to the east. You have pulled into a bay to dock near the island and are prepared to explore the land in search of treasure

You can see Shovel here.

>xship
That's not a verb I recognise.

>x ship
You can't see any such thing.